#######################################
###..........###.##P................###
##.#####.###........#######.######.####
##.#####..###..####.#.......#.......###
##.#................#.#####....#####.##
##.#.##.#############.##.##..####....##
##.#....#........#..########......##..#
##.#.##.#.#########.#.##.....##.####..#
####.##.#.###.......#.##.###....####..#
#.##.##.#.####.#.##.#.##.#######..##..#
#.......#.##...#.##.#.##.##.#..######.#
#.###.###.##.###.##......##.###....##.#
#.#.#.###.##.#.#.##################.#.#
#.........##.#.#.......####.###.......#
#.#...###.##.#.#.#####.####.###.###.#.#
###.#.###.##.#########.##########.#.#.#
####..###..........#..........###.#.#.#
####.#..######.#####.####.###.###...#.#
##.#.#####..##.#..#.#####.#.#....#.#.##
##.#.....#####.####.......######.#.#.##
##.#####.........##.#######.##...#.#.##
#..################.###.###.##.#.###.##
#.##.###............#.#.###.##.#......#
#.##.###.##################.##.#..#..##
#..#####....................##.##.#..##
#..########################.##.###.#.##
##.##.###....##.##.######.#.#...##.#.##
##.##.####.####.##.#...##.#.#.#.##.#.##
###...####......######.##.#.#.#..###.##
##.###.########.##..##.##.#.#.##....###
##.##........##.###.##.##.#.#....###.##
##.#.###.###.##.###.##.####.#####.##.##
##.#.........######......##.........B##
##.#########.##....###.################
#######################################