#############
#P...#......#
#.###.#.#####
#*.#....#####
########B####