############################################################
#P.......#.................#.....................#........##
#.#####.#.###############.#.###################.#.######.###
#.#...#.#.#.............#.#.................#...#.#....#.###
#.#.#.#.#.#.###########.#.###############.#.###.#.#.##.#.###
#...#.#.#.#.#...........#...............#.#...#.#.#..#.#.###
#####.#.#.#.#.#######################.#.###.#.#.#.##.#.#.###
#.....#.#.#.#...............#.......#.#.....#.#.#..#.#.#.###
#.#####.#.#.###############.#.#####.#.#######.#.##.#.#.#.###
#.#.....#.#.#...............#.#...#.#.......#.#...#.#.#.####
#.#.#####.#.#.###############.#.#.#.#######.#.###.#.#.#.####
#.#.....#.#.#.................#.#.#.#.....#.#...#.#.#.#.####
#.#####.#.#.###################.#.#.#.###.#.###.#.#.#.#.####
#.....#.#.#.....................#.#.#.#.#.#.#...#.#.#.#.####
#####.#.#.#####################.#.#.#.#.#.#.#.###.#.#.#.####
#.....#.#.#.....................#.#.#.#.#.#.#...#.#.#.#.####
#.#####.#.#.#####################.#.#.#.#.#.###.#.#.#.#.####
#.#.....#.#.......................#.#.#.#.#.#...#.#.#.#.####
#.#.#####.#########################.#.#.#.#.#.###.#.#.#.####
#.#.#.............................#.#.#.#.#.#.....#.#.#.####
#.#.#.###########################.#.#.#.#.#.#######.#.#.####
#.#.#.#.........................#.#.#.#.#.#.........#.#.####
#.#.#.#.#######################.#.#.#.#.#.###########.#.####
#.#.#.#.#.....................#.#.#.#.#.#.#...........#.####
#.#.#.#.#.###################.#.#.#.#.#.#.#.###########.####
#.#.#.#.#.#.................#.#.#.#.#.#.#.#.#...........####
#.#.#.#.#.#.###############.#.#.#.#.#.#.#.#.#.##############
#.#.#.#.#.#.#...............#.#.#.#.#.#.#.#.#.#..........###
#.#.#.#.#.#.#.###############.#.#.#.#.#.#.#.#.#.############
#.#.#.#.#.#.#...................#.#.#.#.#.#.#.#.#........B##
#.#.#.#.#.#.#####################.#.#.#.#.#.#.#.############
#.#.#.#.#.#.......................#.#.#.#.#.#.#...........##
#.###.#.#.#########################.#.#.#.#.#.##############
#.....#.#...........................#.#.#.#.#..............#
############################################################
