#######################################
################.##P................###
##.#############.##.#######.######.####
##.################.####.##.#.......###
##.#................#.#####..#######.##
##.#.################.##.##..####.##.##
##.#.####...........########.####.##..#
##.#.####.#########.####.....##.####..#
####.####.###..####.####.###.##.####..#
#.##.####.####.#.##.####.###########..#
#.##..###.##.#.#.##.####.##.#########.#
#.###.###.##.###.##......##.###.#####.#
#.#.#.###.##.###.##################.#.#
#.#.#.###.##.###.#####.####.###.###.#.#
#.#.#.###.##.###.#####.####.###.###.#.#
###.#.###.##.######################.#.#
####.####.................###.#####.#.#
####.####################.###.#####.#.#
##.#.#########.##########.######.###.##
##.#.###.#####.####.......######.###.##
##.#####.##########.#######.####.###.##
##.################.###.###.####.###.##
####.###............###.###.##.#.######
####.###.##################.##.#..#..##
##.#####....................##.##.#..##
##.########################.##.#####.##
##.##.#########.##.########.########.##
##.##.####.####.##.########.###.####.##
##########.####.######.####.###..###.##
######.########.######.####.####.###.##
######.########.######.####.####.###.##
####.###.######.###.##.####.####.######
####.#######.######.##.####.........B##
############.#########.################
#######################################