#############################
#.P.......#................##
#.#####.###.#############.#.#
#.#...#.#...#.............#.#
#.#.#.#.###.#.###########.#.#
#.#.#.#.....#.#...........#.#
#.#.#####################.#.#
#.......................#.#.#
#.####..###############.#.#.#
#.#...................#.#.#.#
#.#.##########..#####.#.#.#.#
#.#.#...............#.#.#.#.#
#.#.#.#####..######.#.#.#.#.#
#.#.#.#...........#.#.#.#.#.#
#.#.#.#.###...#####.#.#.#.#.#
#.#.#.#.#.......#.#.#.#.#.#.#
#.#.#.#.###B###.#.#.#.#.#.#.#
#.#.#.#.#.....#.#.#.#.#.#.#.#
#.#.#.#.#####.#.#.#.#.#.#.#.#
##############################