############################################################
#P..........##.##...####....................##...####....###
#.####.####.##.#########.######.###.##.####...............##
#...............................###.##.####.###########.####
#.############.######.#########..........##.###########.####
#.##....###..###................###########...............##
#....##....#####.####.###.#..##############.#######.###.####
#.##############.####.###.###...............#######.###.####
#............###.####.##...##.#####################.###....#
#####.##.###.###.####.#######.#############.........###.####
###...##.###.###.####.#######...............###########.####
###.####.###.....####.####...##############.###########...##
###.####.#########..#.####.#.#######.....##..........####.##
###.####.############.####.#.#######.###....########.####.##
###.####.##...........####.#.....###.#########....##.####.##
###...##.#############.....#####.###.###############.####.##
###..###.##.......####.#########.###.###.....#######.####.##
####.###.##.#####.####........##.###.###.###.#######....#..#
####.###.##.##.##.###########.##.###.###.###.##########.####
##...###....##.##.###.##...##.##.###.###.###.##....####....#
##..#############.###.##.#.##.##.###.###.###.##.##.#######.#
#.#...............###....#.##.##.###.###.###.##.##......##.#
#.#.#############.###########.##.###.###.###.##.##.####.##.#
#.#.#####.....###.............##..##.....###....##.####.##.#
#.#.#####.###.###.###.#######.####################.####.##.#
#.#.......###..##.###.#######......................####.##.#
#.#.##########.##.#.#...###########.############.#####..##.#
#.###........#.##.#.###.#.......###.###......###.#########.#
#..##.######.#.##.##.##.#.#####.###.######################.#
##......####...##.##.##.#.#####.....######.............###.#
##.####.#########.##.##.#.################.###########.###.#
##.####.##.##.###.###...#...#####..........##....#####.#####
##.####....##.###.#########.#####.########.##.##.#####....##
##.....######.###.......###.......########....##......######
############################################################
