##########################
#P...B#......#...........#
#.##.#.####.#.#######....#
#...#.#....#.#.......#...#
###.#.#.##.#.#.###.#.#.###
#...#.#..#...#...#.#.#...#
#.###.##.######.#.#.###..#
#...#.....#...#.#.#...#..#
#.#.#####.#.#.#.#.###.##.#
#.#.....#.#.#.#.#.....#..#
#.#####.#.#.#.#.#####.#.##
#.#...#.#...#.#.....#.#..#
#.#.#.#.#####.#.###.######
#.#.#.#.......#.#.#.....##
#.#.#.#########.#.###.#..#
#.#.#.#.......#.#...#.#.##
#.#.#.#.#####.#.###.#.#..#
#.#.#.#...#...#.....#...##
#.#.#.###.#.#####.#####.##
#.#.#...#.#.....#.....#.##
#.#.###.#.#.###.#.###.#.##
#.#...#.#.#...#.#...#...##
#.###.#.#.###.#.#######.##
#.....#.....#.#.......#.##
#######.###.#.#######.#.##
#.......#...........#....#
##########################