##############################
#.P..........#...............#
#.######.#####.#####.#########
#.#....#...........#.........#
#.#.#########.#####.#######..#
#.#.........#.......#.....#..#
#.#########.#####.#.#.###.#..#
#.........#.....#.#.#...#.#..#
#########.#####.#.#.#.#.#.####
#.......#.#.....#.....#.#....#
#.#####.#.#.###########.####.#
#.#...#.#.#.....#.....#......#
#.#.#.#.#.#####.#.###.########
#.#.#.#.#.....#.#...#........#
#.#.#.#.#####.#.###.########.#
#...#.#.....#.#...#........#.#
#####.#####.#.###.#########.##
#.........#.#.#.............##
#.#######.#.#B################
##############################